11111111111111111111111111111111111111111111111111111111111111111111111111111111111111111111111111111111111111111111111111111111
10000000000000000000000000000000000000000000000000000000000000000000000000000000000000000000000000000000000000000000000000000001
10000000000000000000000000000000000000000000000000000000000000000000000000002002002200222220000200000200200000000000000000000001
10000000000000000000000000000000000000000000000000000000000000000000000000002020020020000200002020000202000000000000000000000001
10000000000000000000000000000000000000000000000000000000000000000000000000002200020020002000022222000220000000000000000000000001
10000000000000000000000000000000000000000000011000000000000000000000000000002020020020020000020002000202000000000000000000000001
10000000000000000000000000000000000000000000000000100000000000000000000000002002002200222220200000200200200000000000000000000001
10000000000000000000000000000000000000000000000000000000000000000000000000000000000000000000000000000000000000000000000000000001
10000000000000000000000000000000000000000000000000000001221111111100000000000000000000000000000000000000000000000000000000000001
10000000000000000000000000000000000000000000000000000000000000000000000000000000000000000000000000000000000000000000000000000001
10000000000000000000000000000000000000000000000000000000000000000000022221111111112111100000000000000000000000000000000000000001
10000N00000000000000000000000000000000000000000000000000000000000000000000000000000000000000000000000000000000000000000000000001
10000000000000000000000000000000000000000000000001111112222211111221111111221111000000000000000000000000000000000000000000000001
10000000000001100022220000222000000000112221100000000000000000000000000000000000000000000000000000000000000000000000000000000001
10000000000000000000000000000000000000000000000000000000000000000000000000000000000000000000000000000000000000000000000000000001
11111111111111111111111111111111111111111111111111111111111111111111111111111111111111111111111111111111111111111111111111111111
