11111111111111111111111111111111111111111111111111111111111111111111111111111111111111111111111111111111111111111111111111111111
10000000000000000000000000000000000000000000000000000000000000000000000000000000000000000000000000000000000000000000000000000001
10000002222000000000000000000000000000000000000000000000000000000000000000000000000000000000000000000000000000000000000000000001
10000220000220000000000000000000000000000000000000000000000000000000000000000000000000000000000000000000000000000000000000000001
10000220000220000000000000000000000000000000000000000000000000000000000000000000000000000000000000000000000000000000000000000001
10000000002200000000000000000000000000000000000000000000000000000000000000000000000000000000000000000000000000000000000000000001
10000000022000000000000000000000000000000000000000000000000000000000000000000000000000000000000000000000000000000000000000000001
10000000220000000000000000000000000000000000000000000000000000000000000000000000000000000000000000000000000000000000000000000001
10000002200000000000000000000000000000000000000000000000000000000000000000000000000000000000000000000000000000000000000000000001
10000222222220000000000000000000000000000000000000000000000000000000000000000000000000000000000000000000000000000000000000000001
10000000000000000000000000000000000000000000000000000000000000000000000000000000000000000000000000000000000000000000000000000001
10000000000000000000000000000000000000000000000000000000000000000000000000000000000000000000000000000000000000000000000000000001
10000000000000000000000000000000000000000000000000000000000000000000000000000000000000000000000000000000000000000000000000000001
10000000000000000000000000000000000000000000000000000000000000000000000000000000000000000000000000000000000000000000000000000001
10000000000000000000000000000000000000000000000000000000000000000000000000000000000000000000000000000000000000000000000000000001
11111111111111111111111111111111111111111111111111111111111111111111111111111111111111111111111111111111111111111111111111111111
